0 0 0 0 0 0 0 0 0 0 0 0 0 0 0 0 0 0 0 0 
0 9 9 9 9 9 9 9 9 9 9 9 9 9 9 9 9 9 9 0 
0 9 8 8 8 8 8 8 8 8 8 8 8 8 8 8 8 8 9 0 
0 9 8 1 2 1 1 3 2 1 2 3 1 2 1 2 3 8 9 0 
0 9 8 2 3 2 1 2 1 1 3 1 1 2 1 2 3 8 9 0 
0 9 8 1 3 2 2 3 2 2 2 3 2 1 1 1 3 8 9 0 
0 9 8 3 2 3 2 1 1 2 2 3 3 3 1 2 2 8 9 0 
0 9 8 3 2 1 3 3 3 1 3 1 2 3 2 2 2 8 9 0 
0 9 8 2 2 2 3 2 3 3 2 2 2 2 2 3 2 8 9 0 
0 9 8 3 2 2 2 2 1 1 2 1 1 3 2 3 3 8 9 0 
0 9 8 1 2 3 1 1 2 1 3 3 3 3 3 1 1 8 9 0 
0 9 8 2 1 3 3 1 1 3 1 2 1 2 3 3 2 8 9 0 
0 9 8 3 3 1 1 3 1 1 1 1 2 3 1 2 2 8 9 0 
0 9 8 1 3 2 3 2 3 2 2 2 3 3 3 2 2 8 9 0 
0 9 8 1 3 1 2 3 3 3 3 2 3 2 1 1 2 8 9 0 
0 9 8 2 1 2 3 1 3 1 1 2 2 2 2 3 3 8 9 0 
0 9 8 1 3 1 3 2 3 3 1 2 1 1 2 3 2 8 9 0 
0 9 8 8 8 8 8 8 8 8 8 8 8 8 8 8 8 8 9 0 
0 9 9 9 9 9 9 9 9 9 9 9 9 9 9 9 9 9 9 0 
0 0 0 0 0 0 0 0 0 0 0 0 0 0 0 0 0 0 0 0 
